1111111111111
0000000000001
1111111000001
      1000001
      1000001
      1000001
      1111111