           1111111111111  11111111
1111111111110333333300011110000001
1000000000003000000000003300000001
1000000300000000000000003300000001
1000000000000000000000003300000001
1111111111110000000000011110000001
           1000000000001  10000001
           1000000000001  10000001
           1000000000001  11111111
           1000000000001
           1000000000001
           1000000000001    1111111111111111    11111111111111111     11111111111111111     11111111111111111
           1000000000001    1000000000000001    10000000000000001     10000000000000001     10000000000000001
           1000000000001    1000000000000001    10000000000000001     10000000000000001     10000000000000001
           1000000000001    1000000000000001    10000000000000001     10000000000000001     10000000000000001
           1000000000001    1000000000000001    10000000000000001     10000000000000001     10000000000000001
           1000000000001    1000000000000001    10000000000000001     10000000000000001     10000000000000001
           1000000000001    1111111000111111    11111110001111111     11111100011111111     11111100011111111
           1000000000001111111111110001111111111111111100011111111111111111100011111111111111111110001111111111111
           1000000000000000000000000000000000000000000000000000000000000000000000000000000000000000000000000000011
           1000000000000000000000000000000000000000000000000000000000000000000000000000000000000000000000000000011
           1000000000000000000000000000000000000000000000000000000000000000000000000000000000000000000000000000011
           1000000000001111111111110001111111111111111100011111111111111111100011111111111111111110001111111111111
           1000000000001    1111111000111111    11111110001111111     11111100011111111     11111100011111111
           1111100011111    1000000000000001    10000000000000001     10000000000000001     10000000000000001
           1111100011111    1000000000000001    10000000000000001     10000000000000001     10000000000000001
           1000000000001    1000000000000001    10000000000000001     10000000000000001     10000000000000001
           1000000000001    1000000000000001    10000000000000001     10000000000000001     10000000000000001
           1000000000001    1000000000000001    10000000000000001     10000000000000001     10000000000000001
           1000000000001    1111111111111111    11111111111111111     11111111111111111     11111111111111111
           1111111111111