111111111111111111111111111111111111111
100000333333011100066000111000044440001
100000000000011100000000111000000000031
100000000000011111000011111000000000031
100000000000000000000000000000000000031
100000000000000000000000000000000000001
111111111111100011111111000111111111111
100000000000100010066001000100000000001
140000000000000000000000000000000005551
140000000000000000000000000000000005551
140000000000100010000001000100000005551
140000000000100010000001000100000005551
100033300000100010066001000100000000001
111111111111100011111111000111111111111
100000000000100010066001000100000000001
140000000000000000000000000000000005551
140000000000000000000000000000000005551
140000000000100010000001000100000005551
140000000000100010000001000100000005551
100033300000100010066001000100000000001
111111111111100011111111000111111111111
100000000000000000000000000000000000001
140000000000000000000000000000000000031
140000000000111100001111000000000000031
140000000000100000000001000000000000031
100044440000100066660001000004444000001
111111111111111111111111111111111111111
