111111111111111111111111111111111111111
100000000000011100000000111000000000001
100000000000011100000000111000000000001
100000000000011111000011111000000000001
100000000000000000000000000000000000001
100000000000000000000000000000000000001
111111111111100011111111000111111111111
100000000000100010000001000100000000001
100000000000000000000000000000000000001
100000000000000000000000000000000000001
100000000000100010000001000100000000001
100000000000100010000001000100000000001
100000000000100010000001000100000000001
111111111111100011111111000111111111111
100000000000100010000001000100000000001
100000000000000000000000000000000000001
100000000000000000000000000000000000001
100000000000100010000001000100000000001
100000000000100010000001000100000000001
100000000000100010000001000100000000001
111111111111100011111111000111111111111
100000000000000000000000000000000000001
100000000000000000000000000000000000001
100000000000111100001111000000000000001
100000000000100000000001000000000000001
100000000000100000000001000000000000001
111111111111111111111111111111111111111
